XXXXXXXXXXX
P         X
X XXX XXX X
X   X   X X
XXXXX X XXX
X   X X   X
X X XXX X X
X X   X X X
X XXX XXX X
X   X     X
XXXXKXXXXXX
